"XXXXXXXXXXXXXXXXXXXX     XXXX",
"X    X    X    X   X     X P ",
"X    X  XXX        X     X   ",
"X    X  X X        X   XXX   ",
"X    X  X X X  X   X     X   ",
"X   XX    X X  X   X         ",
"X   X     X X  X   X         ",
"    XXXX  XXX  X   XXXXXXX   ",
"    X          X    X        ",
"  X X          X  XXX        ",
"  XXX          X    X        ",
"  X    XXXXXX  X        XXXXX",
"         X     X        X   X",
"         X     X        X   X",
"X  X     X   XXXXXXXX   X   X",
"X  XXX   X          X   X   X",
"X    X   X                  X",
"X    X   X                  X",
"X    X   X   XXXX   X       X",
"XXXXXX   X   X      XXXXX   X",
"X    X   X   X          XX  X",
"X    XXX X   X          XX  X",
"X        X   X   XXXXXXXX   X",
"X        X   X      X       X",
"XXXXXXXXXXXXXX      X       X"