"XXXXXXXXXXXXXXXXXXXXXXXXXXXXX",
"P X       X    X   X X  TX  X",
"  X  X   XXX       X X   X  X",
"X    X  XTX    X     X XXX  X",
"XXXXXX  X X X  X   X     X  X",
"XT  X   X X X  X   X   XX   X",
"XXX     X X X  XXX X        X",
"X   XXXX  XXX  X   XXXXXXX  X",
"X      X    X  X    X X     X",
"X   XXXX  XXX  X  XXX XXXXX X",
"X  XX          X    X     X X",
"X XX   XXXXXXXXX      X XXX X",
"X        X     XXXXXXXX X   X",
"XXXXXXXX X     XT       X   X",
"X        X   XXXXXXXXXXXX   X",
"X  XXX X     X  X   X       X",
"X    X XXXXX X  XX       X  X",
"XXX  X X   X X    T XXXXXX  X",
"X    X X XXX XXXXX  X       X",
"XXXXXX   X   X   X  XXXXX   X",
"XTX  X   X   X X X      XXXXX",
"X X  XXX X   X X XXX    X    ",
"X XX   X X T X X    XXXXX    ",
"X        X     XX           ",
"XXXXXXXXXXXXXXXX XXXXXXXXXXXX"
